########
#      #
#@ $   #
#   $  #
# . .  #
########
