########
#     .#
#@ $   #
#   $  #
# . .$ #
########
