########
#      #
#  $   #
#   $  #
# + .  #
########
