#######
#.@ # #
#$. $ #
# $ $ #
# ..  #
#  *  #
#######
