########
#--#---#
#.-#---#
#.--$$-#
#--#---#
#--#-@-#
########
