     ####
    ##. ##
##### .  #
#   #  # #
# $ #  # #
# $  @   #
######  ##
     ####
